%%%%%%%%%%%%%%%%%%%%%%%%%%%%%%%%
%  ....  P   ....    ........  %
%...  ...  ...  ...  ........  %
%     ...      ....  ...       %
%  ....      ....G   ......    %
%     ...  ....           ...  %
%...  ...  .......   ........  %
%  ....    .......   ......   o%
%%%%%%%%%%%%%%%%%%%%%%%%%%%%%%%%
